|-----------|
|          X|
|.----------|
|           |
|----------.|
|           |
|.----------|
|           |
|----------.|
|           |
|.----------|
|           |
|----------U|