|-------------|
|  X          |
|----- ------ |
|      |      |
|-- |- | ---- |
|   |  |  |   |
|----  |  | --|
|      |      |
|- -|- ------ |
|   |         |
| ------------|
|             U
|-------------|