|------|---|------|---------------------------|---------|
| X    .   |      |                           .         |
|--|   |   |  |- -|                           |         |
|      |   |  |   |    ||===||   ||    ||     |         |
|  --|.|-.|-  |- -|    || U ||    \\   //     |         |
|    | |  |    | -|    ||===||     \\ //      |         |
|.---|.-|.|--.-|  |    ||            //       |         |
|    |  | |    |- |    ||           //        |         |
|---.|.-|-|-   |- |    ||          //         |         |
|    |  .      |  |                           |         |
|.|--|--|--.|--|  |---|-.----------|--|-------|---|     |
| |     |   |    -|   |                           |     |
| |---  |---|         |------------|--|--------   |     |
| .     |         |                               |     |
|-|-----|---------|----------------|--|-----------|----U|